NO textures/Mona_Lisa.png
SO textures/Wheat_Field.png
WE textures/the_starry_night.png
EA textures/girl_with_a_pearl_earring.png

C 0,0,60
F 60,179,110

11111111111111111111111111111
10000000001110000000000000111
10110000011110000000000001111
100100000001000000N0000011111
11111111101100000111000000001
10000000001100000111011111011
11110111111111011100000010001
11110111111111011101010010001
11000000110101011100000010001
10000000000000001100000010001
10000000000000001101010010001
11000001110101011111011110001
11110111 10110101 11111010001
11111111111111111111111111111