NO textures/gumball.xpm
SO textures/darwin.xpm
WE textures/ricardo.xpm
EA textures/mae.xpm

C 255,255,255
F 0,0,60

11111111111111111111111111111
10000000000000000000000000001
100E0000000000000000000000001
10000000000000000000000000001
10000000000000000000000000001
10000000000000000000000000001
11110111111000000000000010001
11110111111000000001010010001
11000000110101011100000010001
10000000000000001100000010001
10000000000000000000000010001
10000000000000000000000000001
11111111111111111111111111111