NO textures/gumball.xpm
SO textures/darwin.xpm
WE textures/ricardo.xpm
EA textures/mae.xpm

F 220,100,0
C 225,30,0

        1111111111111111111111111
        1000000000000000000000001
        1011000000000000000000001
        100100N000000000000000001
111111111011000000000000000000001
100000000011000001110111111111111
11110000000000011100000010001
11110000000000000001010010001
11000000000000000000000010001
10000000000000001100000010001
10000000000000001101010010001
110000011101010000000000N0111
11110111 1110101 101111010001
11111111 1111111 111111111111