NO textures/gumball.xpm
SO textures/darwin.xpm
WE textures/ricardo.xpm
EA textures/mae.xpm

F 220,100,12
C 224,255,1

        1111111111111111111111111
        1011000001110111111111111
        1000000000000000000000001
        101100000000W000000000011
        10110000000000001111111
10011111100000000000011111
11111111100000001110000001001
11110000000000000001010010001
11000000000000000000000010001
10000000000000001100000010001
10000000000000001101010010001
11000001110101001000000001111
11111111 1110101 101111010001
11110111 1111111 111011111111