NO textures/gumball.xpm
SO textures/darwin.xpm
WE textures/ricardo.xpm
EA textures/mae.xpm

F 220,100,12
C 224,255,2

        1111111111111111111111111
        1011000001110111111111111
        1000000000000000000000001
        1011000000000000000000001
        10110000000000000000S0011
        1001000000000000000010011
11110000000000011100000010001
11110000000000000001010010001
11000000000000000000000010001
10000000000000001100000010001
10000000000000001101010010001
11000001110101001000000001111
11111111 1110101 101111010001
11110111 1111111 111011111111