NO textures/gumball.xpm
SO textures/darwin.xpm
WE textures/ricardo.xpm
EA textures/mae.xpm

C 0,0,60
F 60,179,110

11111111111
10000000001
10000000001
100W0000001
10000000001
10000000001
10000000001
10000000001
10000000001
10000000001
10000000001
10000000001
10000000001
11111111111